#separator:tab
#html:true
Dear Mr./Mrs. [surname] (formal opening)	Beste meneer/mevrouw [ACHTERNAAM]
I am writing to you because... (formal)	Ik schrijf u omdat...
I would like to request... (formal)	Ik wil ... vragen
Would it be possible to...? (formal)	Zou het mogelijk zijn om...?
I look forward to hearing from you (formal)	Ik hoor graag van u
With kind regards (formal closing)	Met vriendelijke groet
My apologies for the inconvenience (formal)	Mijn excuses voor het ongemak
I have an appointment at... (formal)	Ik heb een afspraak bij/om...
The appointment lasts approximately... (formal)	De afspraak duurt ongeveer...
I would like to have Friday off (formal)	Ik wil vrijdag vrij hebben
I am writing to you because I have a question (formal)	Ik schrijf u omdat ik een vraag heb
I am writing to you because I have a problem (formal)	Ik schrijf u omdat ik een probleem heb
Could I reschedule the appointment? (formal)	Zou het mogelijk zijn om de afspraak te verzetten?
Could I have time off? (formal)	Zou het mogelijk zijn om vrij te hebben?
I am writing to you because something is broken (formal)	Ik schrijf u omdat er iets kapot is
Thank you for your time (formal)	Bedankt voor uw tijd
I hope to hear from you soon (formal)	Ik hoop snel van u te horen
Hello [first name] (informal opening)	Hallo [VOORNAAM]
Unfortunately I cannot... (informal)	Ik kan helaas niet...
I'm sorry! (informal)	Het spijt me!
Can we...? (informal suggestion)	Kunnen we...?
Will you let me know? (informal)	Laat je het me weten?
Greetings (informal closing)	Groetjes
I can't meet tomorrow (informal)	Ik kan morgen niet afspreken
I have to go to the dentist (informal)	Ik moet naar de tandarts
That takes all morning (informal)	Dat duurt de hele ochtend
Can we meet next Tuesday? (informal)	Kunnen we volgende week dinsdag afspreken?
Can we meet at 14:00? (informal)	Kunnen we om 14:00 uur afspreken?
Unfortunately I can't come (informal)	Ik kan helaas niet komen
Could we reschedule? (informal)	Kunnen we een andere afspraak maken?
I'm sorry about that! (informal)	Het spijt me!
Let me know what works for you (informal)	Laat je het me weten?
Thanks in advance! (informal)	Alvast bedankt!
See you soon! (informal)	Tot snel!
That's not a problem (informal)	Dat is geen probleem
Is that okay with you? (informal)	Is dat goed voor jou?
Can you do three things today?	Kun je vandaag drie dingen doen?
Do you want to...? (task assignment)	Wil je...?
Can you also...? (task assignment)	Kun je ook...?
Don't forget to... (reminder)	Vergeet niet om...
Thanks in advance! (work note)	Alvast bedankt!
Greetings (work note closing)	Groetjes
Hello [name], (work note opening)	Hallo [NAAM],
Can you vacuum the store?	Kun je de winkel stofzuigen?
Can you hang the clothes?	Kun je de kleren ophangen?
Don't forget to lock the door	Vergeet niet om de deur op slot te doen
At the end of the day	Aan het eind van de dag
Can you make coffee?	Kun je koffie maken?
Can you do the dishes?	Kun je de afwas doen?
Can you mop the floor?	Kun je de vloer dweilen?
Can you set the tables?	Kun je de tafels dekken?
Can you call the customer?	Kun je de klant bellen?
Can you make copies?	Kun je kopiÃ«ren?
I like to... (newsletter)	Ik ... graag
I do this usually on... (newsletter)	Ik doe dit meestal op...
This is relaxing (newsletter)	Dit is ontspannend
This is nice/cozy (newsletter)	Dit is gezellig
This is important to me (newsletter)	Dit is belangrijk voor mij
I celebrate every year... (newsletter)	Ik vier elk jaar...
I like to walk on the weekend (newsletter)	Ik wandel graag in het weekend
I usually do this on Saturday (newsletter)	Ik doe dit meestal op zaterdag
This is relaxing and healthy for me (newsletter)	Dit is ontspannend en gezond voor mij
I like to spend time with my friends (newsletter)	Ik graag tijd met mijn vrienden doorbreng
We always go out to eat (newsletter)	We gaan altijd uit eten
This is nice because... (newsletter)	Dit is gezellig omdat...
In the park (location)	In het park
With my wife/husband (with whom)	Met mijn vrouw/man
With friends (with whom)	Met vrienden
On Saturday (time)	Op zaterdag
In the weekend (time)	In het weekend
Every week (frequency)	Elke week
Every year (frequency)	Elk jaar
Always (frequency)	Altijd
Usually (frequency)	Meestal
Sometimes (frequency)	Soms
First and last name (form field)	Voor- en achternaam
Address (form field)	Adres
Postal code (form field)	Postcode
City (form field)	Woonplaats
Phone number (form field)	Telefoonnummer
Email address (form field)	E-mailadres
Date of birth (form field)	Geboortedatum
The thieves stole my laptop (form description)	De dieven hebben mijn laptop gestolen
They also took my watch (form description)	Ze hebben ook mijn horloge meegenomen
The window is broken (form description)	Het raam is kapot
The living room window is broken (form description)	Het raam van de woonkamer is kapot
There is a lot of garbage on the street (complaint)	Er ligt veel vuilnis op straat
The paving stone is loose (complaint)	Er is een stoeptegel los
Something is broken	Er is iets kapot
I have a complaint	Ik heb een klacht
The ... is not working	De/Het ... werkt niet
Next week (time)	Volgende week
Tomorrow (time)	Morgen
Today (time)	Vandaag
This morning (time)	Vanmorgen
This afternoon (time)	Vanmiddag
This evening (time)	Vanavond
Monday (day)	Maandag
Tuesday (day)	Dinsdag
Wednesday (day)	Woensdag
Thursday (day)	Donderdag
Friday (day)	Vrijdag
Saturday (day)	Zaterdag
Sunday (day)	Zondag
At 10:00 (time)	Om 10:00 uur
At 14:00 (time)	Om 14:00 uur
Approximately two hours	Ongeveer twee uur
The whole morning	De hele ochtend
The whole day	De hele dag
All day	De hele dag
Boss/manager (formal)	Manager / Leidinggevende
Teacher (formal)	Leraar / Docent
Colleague (neutral)	Collega
Classmate (neutral)	Medestudent / Klasgenoot
Doctor (professional)	Dokter
Dentist (professional)	Tandarts
Physiotherapist (professional)	Fysiotherapeut
Appointment (noun)	De afspraak
To request time off	Vrij vragen
To reschedule	Verzetten
To swap (shifts)	Ruilen
Birthday	Jarig / Verjaardag
I am sick	Ik ben ziek
Because I am sick	Omdat ik ziek ben
I have a fever	Ik heb koorts
I have a backache	Ik heb rugpijn
I have a headache	Ik heb hoofdpijn
To you (formal)	U
To you (informal)	Jij / Je
Your (formal)	Uw
Your (informal)	Jouw / Je
You are (formal)	U bent
You are (informal)	Jij bent / Je bent
Can you (formal)	Kunt u
Can you (informal)	Kun je
Do you want (formal)	Wilt u
Do you want (informal)	Wil je
I am writing to you (formal)	Ik schrijf u
I am writing to you (informal)	Ik schrijf je
Do you have time? (formal)	Heeft u tijd?
Do you have time? (informal)	Heb je tijd?
Could you help me? (formal)	Zou u mij kunnen helpen?
Could you help me? (informal)	Zou je mij kunnen helpen?
Thank you (formal)	Dank u wel
Thank you (informal)	Bedankt / Dank je wel
