#separator:tab
#html:true
I am writing to you because I want to request Friday off	Ik schrijf u omdat ik vrijdag vrij wil vragen
I cannot come tomorrow because I am sick	Ik kan morgen niet komen omdat ik ziek ben
I am writing to you because I have an appointment	Ik schrijf u omdat ik een afspraak heb
I cannot meet because I have to go to the dentist	Ik kan niet afspreken omdat ik naar de tandarts moet
I want time off because it's my birthday	Ik wil vrij omdat ik jarig ben
I am writing because something is broken	Ik schrijf omdat er iets kapot is
This is nice because I like spending time with friends	Dit is gezellig omdat ik graag tijd met vrienden doorbreng
I cannot come because the appointment lasts all morning	Ik kan niet komen omdat de afspraak de hele ochtend duurt
I am writing because I have a question	Ik schrijf omdat ik een vraag heb
I am writing because I have a problem	Ik schrijf omdat ik een probleem heb
I like this because it is relaxing	Ik vind dit leuk omdat het ontspannend is
I need to reschedule because I am sick	Ik moet verzetten omdat ik ziek ben
I cannot work because I have a fever	Ik kan niet werken omdat ik koorts heb
I am late because there is a problem with the train	Ik ben laat omdat er een probleem met de trein is
This is important because I learn a lot	Dit is belangrijk omdat ik veel leer
I need help because my laptop is broken	Ik heb hulp nodig omdat mijn laptop kapot is
I am writing because I want to make a complaint	Ik schrijf omdat ik een klacht wil maken
I cannot swap shifts because I have an appointment	Ik kan niet ruilen omdat ik een afspraak heb
This is nice because it is healthy	Dit is gezellig omdat het gezond is
I like the weekend because I can relax	Ik vind het weekend leuk omdat ik kan ontspannen
I am writing to you because I want to request vacation	Ik schrijf u omdat ik vakantie wil vragen
I need Friday off because of a doctor's appointment	Ik heb vrijdag nodig omdat ik een afspraak bij de dokter heb
I cannot attend class because I am ill	Ik kan niet naar de les omdat ik ziek ben
This is important to me because I enjoy it	Dit is belangrijk voor mij omdat ik ervan geniet
I am writing because the window is broken	Ik schrijf omdat het raam kapot is
I can help you tomorrow	Ik kan u morgen helpen
I can come next Tuesday	Ik kan volgende week dinsdag komen
I cannot meet tomorrow	Ik kan morgen niet afspreken
Can we meet on Wednesday?	Kunnen we woensdag afspreken?
Can we reschedule the appointment?	Kunnen we de afspraak verzetten?
I can work on Friday	Ik kan vrijdag werken
Can you swap shifts with me?	Kun je met mij ruilen?
I cannot come to the meeting	Ik kan niet naar de vergadering komen
Can you help me with this?	Kun je mij hiermee helpen?
I can do that for you	Ik kan dat voor je doen
Can we make a new appointment?	Kunnen we een nieuwe afspraak maken?
I can start at 10:00	Ik kan om 10:00 uur beginnen
Can you call the doctor?	Kun je de dokter bellen?
I can pick it up tomorrow	Ik kan het morgen ophalen
Can you send me the information?	Kun je mij de informatie sturen?
I want to request time off	Ik wil vrij vragen
I want to reschedule the appointment	Ik wil de afspraak verzetten
I want to swap shifts with my colleague	Ik wil met mijn collega ruilen
Do you want to meet next week?	Wil je volgende week afspreken?
I want to have Friday off	Ik wil vrijdag vrij hebben
I want to go to the doctor	Ik wil naar de dokter gaan
Do you want to help me?	Wil je mij helpen?
I want to make an appointment	Ik wil een afspraak maken
I want to ask a question	Ik wil een vraag stellen
Do you want to come to the party?	Wil je naar het feest komen?
I want to celebrate my birthday with friends	Ik wil mijn verjaardag met vrienden vieren
I want to go home early today	Ik wil vandaag vroeg naar huis
I must go to the dentist	Ik moet naar de tandarts
I must work tomorrow	Ik moet morgen werken
I must be at the doctor at 10:00	Ik moet om 10:00 uur bij de dokter zijn
You must fill in the form	U moet het formulier invullen
I must call my boss	Ik moet mijn leidinggevende bellen
I must finish this today	Ik moet dit vandaag afmaken
We must reschedule the meeting	We moeten de vergadering verzetten
I must go now	Ik moet nu gaan
You must not forget to lock the door	Je moet niet vergeten de deur op slot te doen
I must be there at 14:00	Ik moet om 14:00 uur daar zijn
Would it be possible to have Friday off?	Zou het mogelijk zijn om vrijdag vrij te hebben?
Would it be possible to reschedule?	Zou het mogelijk zijn om te verzetten?
Could you help me?	Zou je mij kunnen helpen?
Could we meet next week?	Zouden we volgende week kunnen afspreken?
Would it be possible to swap shifts?	Zou het mogelijk zijn om te ruilen?
Could you send me the information?	Zou u mij de informatie kunnen sturen?
Would it be possible to start later?	Zou het mogelijk zijn om later te beginnen?
Could you call me back?	Zou je mij terug kunnen bellen?
I have an appointment at the doctor at 10:00	Ik heb een afspraak bij de dokter om 10:00 uur
I have an appointment next Friday	Ik heb volgende week vrijdag een afspraak
The appointment lasts approximately two hours	De afspraak duurt ongeveer twee uur
I need to reschedule my appointment	Ik moet mijn afspraak verzetten
Can we make a new appointment?	Kunnen we een nieuwe afspraak maken?
I have a dentist appointment tomorrow morning	Ik heb morgen ochtend een afspraak bij de tandarts
My appointment is at 14:00	Mijn afspraak is om 14:00 uur
I cannot make the appointment	Ik kan niet naar de afspraak komen
The appointment takes all morning	De afspraak duurt de hele ochtend
I need an appointment with the physiotherapist	Ik heb een afspraak met de fysiotherapeut nodig
I have a meeting at work tomorrow	Ik heb morgen een vergadering op het werk
Can we meet on Tuesday at 14:00?	Kunnen we dinsdag om 14:00 uur afspreken?
I work in a store	Ik werk in een winkel
I work in a restaurant	Ik werk in een restaurant
I have to work on Saturday	Ik moet zaterdag werken
I cannot work tomorrow	Ik kan morgen niet werken
My colleague is sick today	Mijn collega is vandaag ziek
I need to swap shifts with my colleague	Ik moet met mijn collega ruilen
Can you work for me on Friday?	Kun je vrijdag voor mij werken?
I start work at 9:00	Ik begin om 9:00 uur met werken
I finish work at 17:00	Ik ben om 17:00 uur klaar met werken
My manager is called Mr. Jansen	Mijn leidinggevende heet meneer Jansen
I need to call my boss	Ik moet mijn chef bellen
I have a shift on Wednesday	Ik heb woensdag dienst
Can you vacuum the office?	Kun je het kantoor stofzuigen?
I need to do the dishes	Ik moet de afwas doen
Can you mop the floor today?	Kun je vandaag de vloer dweilen?
Don't forget to set the tables	Vergeet niet de tafels te dekken
I need to make copies for the meeting	Ik moet kopiÃ«ren voor de vergadering
Can you hang up the laundry?	Kun je de was ophangen?
I take the bus to work	Ik ga met de bus naar het werk
I am sick today	Ik ben vandaag ziek
I have a fever	Ik heb koorts
I have a headache	Ik heb hoofdpijn
I have a backache	Ik heb rugpijn
I need to see the doctor	Ik moet naar de dokter
I feel ill	Ik voel me ziek
I cannot come to work because I am ill	Ik kan niet naar het werk komen omdat ik ziek ben
I need to rest today	Ik moet vandaag rusten
I am feeling better now	Ik voel me nu beter
I was sick yesterday	Ik was gisteren ziek
I'm sorry, I cannot come	Het spijt me, ik kan niet komen
Unfortunately I cannot meet tomorrow	Ik kan helaas morgen niet afspreken
My apologies for the inconvenience	Mijn excuses voor het ongemak
I'm sorry I am late	Het spijt me dat ik laat ben
Sorry, I forgot	Sorry, ik ben het vergeten
I apologize for the late response	Mijn excuses voor de late reactie
I'm sorry, that doesn't work for me	Het spijt me, dat komt mij niet uit
Unfortunately that is not possible	Dat is helaas niet mogelijk
Sorry for the confusion	Sorry voor de verwarring
I apologize, I made a mistake	Mijn excuses, ik heb een fout gemaakt
I'm sorry I cannot help you	Het spijt me dat ik u niet kan helpen
Unfortunately I have to cancel	Ik moet helaas afzeggen
Can we meet next Tuesday at 14:00?	Kunnen we volgende week dinsdag om 14:00 uur afspreken?
Could we reschedule to Wednesday?	Kunnen we verzetten naar woensdag?
Is Friday at 10:00 okay for you?	Is vrijdag om 10:00 uur goed voor u?
What time works for you?	Hoe laat schikt het u?
Shall we say Monday at 15:00?	Zullen we maandag om 15:00 uur zeggen?
Can we make it a bit later?	Kunnen we het iets later maken?
Is next week better for you?	Komt volgende week u beter uit?
How about Thursday morning?	Wat dacht u van donderdagochtend?
Would Tuesday afternoon work?	Zou dinsdagmiddag schikken?
Can we meet in the morning?	Kunnen we 's ochtends afspreken?
Could we do it next week instead?	Kunnen we het volgende week doen?
Is 14:00 okay with you?	Is 14:00 uur goed voor jou?
I like to walk on the weekend	Ik wandel graag in het weekend
I usually do this on Saturday	Ik doe dit meestal op zaterdag
I do this with my wife in the park	Ik doe dit met mijn vrouw in het park
This is relaxing and healthy for me	Dit is ontspannend en gezond voor mij
I celebrate my birthday every year with friends	Ik vier elk jaar mijn verjaardag met vrienden
We always go out to eat in a restaurant	We gaan altijd uit eten in een restaurant
After that we have drinks	Daarna drinken we wat
I like spending time with my friends	Ik breng graag tijd met mijn vrienden door
I play sports twice a week	Ik sport twee keer per week
I like to read books in the evening	Ik lees graag 's avonds boeken
I cook every day for my family	Ik kook elke dag voor mijn gezin
On Sundays I relax at home	Op zondag ontspan ik thuis
I go to Dutch class every Tuesday	Ik ga elke dinsdag naar de Nederlandse les
I like to cycle to work	Ik fiets graag naar het werk
In summer I go swimming often	In de zomer ga ik vaak zwemmen
My laptop is broken	Mijn laptop is kapot
The window of the living room is broken	Het raam van de woonkamer is kapot
The thieves stole my laptop	De dieven hebben mijn laptop gestolen
They also took my watch	Ze hebben ook mijn horloge meegenomen
There is a lot of garbage on the street	Er ligt veel vuilnis op straat
The paving stone is loose	De stoeptegel is los
The heating is not working	De verwarming werkt niet
There is a leak in the ceiling	Er zit een lek in het plafond
The door won't close	De deur gaat niet dicht
My bike was stolen	Mijn fiets is gestolen
The elevator is broken	De lift is kapot
There is too much noise from the neighbors	Er is te veel lawaai van de buren
Next week Friday I want to have time off	Volgende week vrijdag wil ik vrij hebben
Tomorrow I have an appointment at 10:00	Morgen heb ik een afspraak om 10:00 uur
Today I cannot come to work	Vandaag kan ik niet naar het werk komen
On Wednesday I have a meeting	Op woensdag heb ik een vergadering
Last week I was sick	Vorige week was ik ziek
This morning I went to the doctor	Vanmorgen ben ik naar de dokter geweest
This afternoon I have time	Vanmiddag heb ik tijd
This evening I need to study	Vanavond moet ik studeren
On Monday I start my new job	Op maandag begin ik met mijn nieuwe baan
Every Tuesday I have Dutch class	Elke dinsdag heb ik Nederlandse les
