#separator:tab
#html:true
I am writing to you because I want to request Friday off	Ik schrijf u omdat ik vrijdag vrij wil vragen
I cannot come tomorrow because I am sick	Ik kan morgen niet komen omdat ik ziek ben
I cannot meet because I have to go to the dentist	Ik kan niet afspreken omdat ik naar de tandarts moet
I want time off because it's my birthday	Ik wil vrij omdat ik jarig ben
This is nice because I like spending time with friends	Dit is gezellig omdat ik graag tijd met vrienden doorbreng
I cannot come because the appointment lasts all morning	Ik kan niet komen omdat de afspraak de hele ochtend duurt
Would it be possible to have Friday off?	Zou het mogelijk zijn om vrijdag vrij te hebben?
Would it be possible to reschedule?	Zou het mogelijk zijn om te verzetten?
Could we meet next week?	Zouden we volgende week kunnen afspreken?
Could you help me?	Zou je mij kunnen helpen?
I have an appointment at the doctor at 10:00	Ik heb een afspraak bij de dokter om 10:00 uur
The appointment lasts approximately two hours	De afspraak duurt ongeveer twee uur
Can we make a new appointment?	Kunnen we een nieuwe afspraak maken?
Can we meet on Tuesday at 14:00?	Kunnen we dinsdag om 14:00 uur afspreken?
I cannot make the appointment	Ik kan niet naar de afspraak komen
I must go to the dentist	Ik moet naar de tandarts
I must work tomorrow	Ik moet morgen werken
I must be at the doctor at 10:00	Ik moet om 10:00 uur bij de dokter zijn
Don't forget to lock the door	Vergeet niet om de deur op slot te doen
Can you vacuum the office?	Kun je het kantoor stofzuigen?
Can you mop the floor today?	Kun je vandaag de vloer dweilen?
Don't forget to set the tables	Vergeet niet de tafels te dekken
I like to walk on the weekend	Ik wandel graag in het weekend
I usually do this on Saturday	Ik doe dit meestal op zaterdag
I do this with my wife in the park	Ik doe dit met mijn vrouw in het park
This is relaxing and healthy for me	Dit is ontspannend en gezond voor mij
I celebrate my birthday every year with friends	Ik vier elk jaar mijn verjaardag met vrienden
We always go out to eat in a restaurant	We gaan altijd uit eten in een restaurant
I like spending time with my friends	Ik breng graag tijd met mijn vrienden door
I'm sorry, I cannot come	Het spijt me, ik kan niet komen
Unfortunately I cannot meet tomorrow	Ik kan helaas morgen niet afspreken
My apologies for the inconvenience	Mijn excuses voor het ongemak
Unfortunately that is not possible	Dat is helaas niet mogelijk
I am sick today	Ik ben vandaag ziek
I have a fever	Ik heb koorts
I cannot come to work because I am ill	Ik kan niet naar het werk komen omdat ik ziek ben
Next week Friday I want to have time off	Volgende week vrijdag wil ik vrij hebben
Tomorrow I have an appointment at 10:00	Morgen heb ik een afspraak om 10:00 uur
Today I cannot come to work	Vandaag kan ik niet naar het werk komen
On Wednesday I have a meeting	Op woensdag heb ik een vergadering
